111111111111111111111111111111111111111111111111
000000000000000400000000000000020000000000000000
000000000000000400000000000000020000000000000000
000000000000000400000000000000020000000000000000
000000000000000400000000000000020000000000000000
000000000000000400000000000000020000000000000000
000000000000000400000000000000020000000000000000
000000000000000400000000000000020000000000000000
111111111111111111111110011111111111111001111111
000000000000000000000000000000000000000000000000
000000000000000000000000000000000000000000000000
000000000000000000000000000000000000000000000000
000000000000000000000000000000000000000000000000
000000000000000000000000000000000000000000000000
000000000000000000000000000000000000000000000000
000000000000000000000011111111000000000000000000
000000000000000000000040000002000000000000000000
000000000000000000000060000005000000000000000000
000000000000000000000000000000000000011111111111
000000000000000000000000000000000000040000000000
000000000000000000000000000000000000040000000000
111111001111110000000040000002000000040000000000
000000000000020000000011111111000000040000000000
000000000000020000000040000002000000040000000000
000000000000050000000040000002000000040000000000
000000000000000000000000000002000000000000000000
000000000000000000000000000002000000000000000000
000000000000000000000000000002000000000000000000
000000000000020000000040000002000000040000000000
000000000000020000000011111111000000011111111111
