411111111444444444444444441111111111111114444444
400000000400000000000000040000000000000004000004
400000000300000000000000040000000000000004000004
400000000000000000000000040000000000000003000004
400000000000000000000000040000000000000000000004
400000000400000000000000040000000000000000000004
400000000400000000000000040000000000000004000004
400000000400000000000000040000000000000004000004
411111111111111111000000040000000000000004000004
400000000000000004000000041111111111111114000004
400000000000000004000000040000000000000004000004
400000000000000003000000040000000000000004000004
400000000000000000000000040000000000000004000004
400000000000000000000000040000000000000004000004
400000000000000004000000040000000000000004000004
400000000000000004000000040000000000000004000004
400000000000000004000000040000000000000004000004
400000000000000004000000040000000000000004000004
400000000000000004000000040000000000000004000004
411111111111111111000000011111111001111111000004
400000000000000000000000000000000000000000000004
400000000000000000000000000000000000000000000004
400000000000000000000000000000000000000000000004
400000000000000000000000000000000000000000000004
400000000000000000000000000000000000000000000004
400000000000000000000000000000000000000000000004
400000000000000000000000000000000000000000000004
400000000000000000000000000000000000000000000004
400000000000000000000000000000000000000000000004
444444444444444444444444444444444444444444444444
