111111111100000000000000011111111111111111000000
000000000200000000000000040000000000000002000000
000000000500000000000000040000000000000002000000
000000000000000000000000040000000000000005000000
000000000000000000000000040000000000000000000000
000000000000000000000000040000000000000000000000
000000000200000000000000040000000000000000000000
000000000200000000000000040000000000000002000000
111111111111111111000000040000000000000002000000
000000000000000002000000011111111111111111000000
000000000000000002000000040000000000000002000000
000000000000000000000000040000000000000002000000
000000000000000000000000040000000000000002000000
000000000000000000000000040000000000000002000000
000000000000000002000000040000000000000002000000
000000000000000002000000040000000000000002000000
000000000000000002000000040000000000000002000000
000000000000000002000000040000000000000002000000
000000000000000002000000040000000000000002000000
111111111111111111000000011111111001111111000000
000000000000000000000000000000000000000000000000
000000000000000000000000000000000000000000000000
000000000000000000000000000000000000000000000000
000000000000000000000000000000000000000000000000
000000000000000000000000000000000000000000000000
000000000000000000000000000000000000000000000000
000000000000000000000000000000000000000000000000
000000000000000000000000000000000000000000000000
000000000000000000000000000000000000000000000000
000000000000000000000000000000000000000000000000
