000000000000000001111111111111111100000111111111
000000000000000004000000000000000200000400000000
000000000000000006000000000000000200000400000000
000000000000000000000000000000000200000400000000
000000000000000000000000000000000200000400000000
000000000000000000000000000000000200000400000000
000000000000000001111111111111111100000400000000
000000000000000004000000000000000200000111110011
000000000000000004000000000000000200000000000000
000000000000000004000000000000000200000000000000
111111111100000004000000000000000200000000000000
000000000200000004000000000000000200000000000000
000000000500000004000000000000000200000000000000
000000000000000001111111100111111100000000000000
000000000000000000000000000000000000000000000000
000000000000000000000000000000000000000000000000
000000000200000000000000000000000000000000000000
000000000200000000000000000000000000000000000000
111111111100000001111111100111111100000000000000
000000000000000004000000000000000200000000000000
000000000000000004000000000000000200000000000000
000000000000000004000000000000000200000000000000
111111111100000004000000000000000200011111111111
000000000200000004000000000000000200040000000000
000000000500000001111111111111111100060000000000
000000000000000000000000000000000000000000000000
000000000000000000000000000000000000000000000000
000000000000000000000000000000000000000000000000
000000000200000000000000000000000000040000000000
111111111100000000000000000000000000011111111111
