111111111166666666666666611111111111111111666662
400000000200000000000000040000000000000002000002
400000000500000000000000040000000000000002000002
400000000000000000000000040000000000000005000002
400000000000000000000000040000000000000000000002
400000000000000000000000040000000000000000000002
400000000200000000000000040000000000000000000002
400000000200000000000000040000000000000002000002
111111111111111111000000040000000000000002000002
400000000000000002000000011111111111111111000002
400000000000000005000000040000000000000002000002
400000000000000000000000040000000000000002000002
400000000000000000000000040000000000000002000002
400000000000000000000000040000000000000002000002
400000000000000002000000040000000000000002000002
400000000000000002000000040000000000000002000002
400000000000000002000000040000000000000002000002
400000000000000002000000040000000000000002000002
400000000000000002000000040000000000000002000002
111111111111111111000000011111111001111111000002
400000000000000000000000000000000000000000000002
400000000000000000000000000000000000000000000002
400000000000000000000000000000000000000000000002
400000000000000000000000000000000000000000000002
400000000000000000000000000000000000000000000002
400000000000000000000000000000000000000000000002
400000000000000000000000000000000000000000000002
400000000000000000000000000000000000000000000002
400000000000000000000000000000000000000000000002
433333333333333333333333333333333333333333333332
