111111111110000000000000000000000000000011111111
000000000020000000000000000000000000000040000000
000000000020000000000000000000000000000040000000
000000000020000000000004000000000000000040000000
000000000020000000000004000000000000000040000000
111110011110000000000004000000000000000011100111
000000000000000000000001111111100000000000000000
000000000000000000000004000000200000000000000000
000000000000000000000004000000500000000000000000
000000000000000000000004000000000000000000000000
111111100110000000000004000000000000000000000000
000000000020000000000004000000000000000000000000
000000000020000000111114000000200000000000000000
000000000020000000400001111111100000000000000000
000000000020000000600004000000000000000000000000
111111111110000000000004000000000000000000000000
000000000000000000000004000000000000000000000000
000000000000000000000001111111111110011111111111
000000000000000000400004000000000000000000000000
111111100000000000111114000000000000000000000000
000000200000000000000004000000000000000000000000
000000500000000000000004000000000000000000000000
000000000000000000000004000011111111000000000000
000000000000000000000004000040000002000000000000
000000000000000000000004000040000005000000000000
000000200000000000000004000040000000000000000000
111111100000000000000004000040000000000000000000
000000000000000000000004000040000000000000000000
000000000000000000000004000040000002000000000000
000000000000000000000001111111111111111111111111
