111111111444444444444444411111111111111111444442
400000000400000000000000040000000000000002000002
400000000500000000000000040000000000000002000002
400000000000000000000000040000000000000005000002
400000000000000000000000040000000000000000000002
400000000400000000000000040000000000000000000002
400000000400000000000000040000000000000002000002
400000000400000000000000040000000000000002000002
111111111111111111000000040000000000000002000002
400000000000000002000000011111111111111111000002
400000000000000002000000040000000000000002000002
400000000000000005000000040000000000000002000002
400000000000000000000000040000000000000002000002
400000000000000000000000040000000000000002000002
400000000000000002000000040000000000000002000002
400000000000000002000000040000000000000002000002
400000000000000002000000040000000000000002000002
400000000000000002000000040000000000000002000002
400000000000000002000000040000000000000002000002
111111111111111111000000011111111001111111000002
400000000000000000000000000000000000000000000002
400000000000000000000000000000000000000000000002
400000000000000000000000000000000000000000000002
400000000000000000000000000000000000000000000002
400000000000000000000000000000000000000000000002
400000000000000000000000000000000000000000000002
400000000000000000000000000000000000000000000002
400000000000000000000000000000000000000000000002
400000000000000000000000000000000000000000000002
433333333333333333333333333333333333333333333332
