111111111110000000000000000000111111111111111111
000000000020000000000000000000400000000000000000
000000000050000000000000000000400000000000000000
000000000000000000000000000000400000000000000000
000000000000000000000000000000400000000000000000
000000000000000000000000000000400000000000000000
000000000020000000000000000000111111111001111111
111111111110000000000000000000000000000000000000
000000000000000000000000000000000000000000000000
000000000000000000000000000000000000000000000000
000000000000000000000000000000000000000000000000
000000000000000000000000000000111111111001111111
000000000000000000000000000000400000000000000000
000000000000000000000000000000400000000000000000
000000000000000000000000000000400000000000000000
000000000000000001111111111111400000000000000000
000000000000000004000000000000400000000000000000
000000000000000006000000000000400000000000000000
000000000000000000000000000000400000000000000000
000000000000000000000000000000400000000000000000
000000000000000000000000000000400000000000000000
000000000000000004000000000000400000000000000000
001111111100000001111111111111400000000000000000
004000000200000000000040000000400000000000000000
004000000500000000000060000000400000000000000000
004000000000000000000000000000400000000000000000
004000000000000000000000000000400000000000000000
004000000000000000000000000000400000000000000000
004000000200000000000040000000400000000000000000
001111111100000000000011111111111111111111111111
